Reinforced_Crossbow damage	5
P8_Luger    damage	0
Holy_Arrows damage	0
Sharpened_Arrows    damage	0
Armor_Piercing_Arrows   damage	0
The_Nail    damage	0
Unholy_Hellbringer  damage	0
Holy_Grail  max_health	0
Crist's_Blood   max_health	0
Energy_Shield   max_health	0
Undying_Heart   max_health	0
Blood_of_the_Martyr max_health	0
Holy_Mantle max_health	0
Dark_Bible   max_health	0
Holy_Water  health	0
Light_Armor movement_speed	0.5
Plate_Armor   movement_speed	0
Experimental_Medicine   movement_speed	0
Light_Boots	jump_speed	0
Lust	jump_speed	0
Aerodynamic_Arrows  shot_speed	0
Steel_Wire  shot_speed	0
DRINK_ME (smaller_hitbox)	0
Ceremonial_Robes    (smaller_hitbox)	0
The_Pact    (smaller_hitbox)	0
Book_of_Revelations (arrow_hitbox_increased)	0
Advanced_Arrows  (arrow_hitbox_increased)	0
Gravitoelectric_Coupler	(gravity_decreased)	0
Demonic_Possession  (gravity_decreased)	0
Self_Propelled_Arrows   (no_gravity_arrows)	0
Gliding_Arrows	(low_gravity_arrows)	0
Tiny_Planet (orbiting_arrows)	0
Diplopia (double_shot)	0
Crossbow_3.0 (triple_shot)	0
The_curse   (bouncy)	0
-Death's_Touch   (instant_death_or_a_lot_of_damage)	0
-Rust   damage	0
-Pride  max_health	0
-Throbbing_Lump   max_health	0
-Leather_Armor  max_health	0
-Envy   health	0
-Raw_Meat   health	0
-Sloth  movement_speed	0
-Hunters_Bow shot_speed	0
-Somatotropin   (larger_hitbox)	0
-Gluttony   (larger_hitbox)	0
-Greed  (larger_hitbox)	0
-Toothpick (arrow_hitbox_decreased)	0
-Confusion_2.1  (inverted_gravity)	0
-Cursed_Arrows (inverted_gravity_arrows)	0
-Confusion  (invereted_controls)	0